#######
#S #  #
# ### #
#     #
# ### #
#   #G#
#######